#SampleID	BarcodeSequence	ForwardPrimer	ReversePrimer
Bacteria.5degrees.13C.Acetate.Lepidocrocite.Fraction.Ultra-heavy	AACCAAGG	GTGYCAGCMGCCGCGGTAA	GACTACHVGGGTATCTAATCC
Bacteria.5degrees.13C.Acetate.Lepidocrocite.Fraction.Heavy	AAGGTACG	GTGYCAGCMGCCGCGGTAA	GACTACHVGGGTATCTAATCC
Bacteria.5degrees.13C.Acetate.Lepidocrocite.Fraction.Midpoint	ACCTACCT	GTGYCAGCMGCCGCGGTAA	GACTACHVGGGTATCTAATCC
Bacteria.5degrees.13C.Acetate.Lepidocrocite.Fraction.Light	ACGTGTTG	GTGYCAGCMGCCGCGGTAA	GACTACHVGGGTATCTAATCC
Bacteria.5degrees.13C.Acetate.Lepidocrocite.Fraction.Ultra-light	ACTGGACT	GTGYCAGCMGCCGCGGTAA	GACTACHVGGGTATCTAATCC
Bacteria.5degrees.13C.Acetate.Sulfate.Fraction.Ultra-heavy	CAGAAGTG	GTGYCAGCMGCCGCGGTAA	GACTACHVGGGTATCTAATCC
Bacteria.5degrees.13C.Acetate.Sulfate.Fraction.Heavy	CATGTGGT	GTGYCAGCMGCCGCGGTAA	GACTACHVGGGTATCTAATCC
Bacteria.5degrees.13C.Acetate.Sulfate.Fraction.Midpoint	CTCTGACT	GTGYCAGCMGCCGCGGTAA	GACTACHVGGGTATCTAATCC
Bacteria.5degrees.13C.Acetate.Sulfate.Fraction.Light	GATCGAAG	GTGYCAGCMGCCGCGGTAA	GACTACHVGGGTATCTAATCC
Bacteria.5degrees.13C.Acetate.Sulfate.Fraction.Ultra-light	GGATATGG	GTGYCAGCMGCCGCGGTAA	GACTACHVGGGTATCTAATCC
Bacteria.5degrees.13C.Acetate.Fraction.Ultra-heavy	GGTTCCTT	GTGYCAGCMGCCGCGGTAA	GACTACHVGGGTATCTAATCC
Bacteria.5degrees.13C.Acetate.Fraction.Heavy	GTGAGTCT	GTGYCAGCMGCCGCGGTAA	GACTACHVGGGTATCTAATCC
Bacteria.5degrees.13C.Acetate.Fraction.Midpoint	TACGATCG	GTGYCAGCMGCCGCGGTAA	GACTACHVGGGTATCTAATCC
Bacteria.5degrees.13C.Acetate.Fraction.Light	TCACTCTG	GTGYCAGCMGCCGCGGTAA	GACTACHVGGGTATCTAATCC
Bacteria.5degrees.13C.Acetate.Fraction.Ultra-light	TCTCCAGT	GTGYCAGCMGCCGCGGTAA	GACTACHVGGGTATCTAATCC
Bacteria.5degrees.12C.Acetate.Fraction.Ultra-heavy	TGGTTCCT	GTGYCAGCMGCCGCGGTAA	GACTACHVGGGTATCTAATCC
Bacteria.5degrees.12C.Acetate.Fraction.Heavy	TGTGACTG	GTGYCAGCMGCCGCGGTAA	GACTACHVGGGTATCTAATCC
Bacteria.5degrees.12C.Acetate.Fraction.Midpoint	AACCGGTT	GTGYCAGCMGCCGCGGTAA	GACTACHVGGGTATCTAATCC
Bacteria.5degrees.12C.Acetate.Fraction.Light	ACGTTGGT	GTGYCAGCMGCCGCGGTAA	GACTACHVGGGTATCTAATCC
Bacteria.5degrees.12C.Acetate.Fraction.Ultra-light	AGGAGAAG	GTGYCAGCMGCCGCGGTAA	GACTACHVGGGTATCTAATCC
Bacteria.10degrees.13C.Acetate.Lepidocrocite.Fraction.Ultra-heavy	AGTCTCAG	GTGYCAGCMGCCGCGGTAA	GACTACHVGGGTATCTAATCC
Bacteria.10degrees.13C.Acetate.Lepidocrocite.Fraction.Heavy	CAACCTAG	GTGYCAGCMGCCGCGGTAA	GACTACHVGGGTATCTAATCC
Bacteria.10degrees.13C.Acetate.Lepidocrocite.Fraction.Midpoint	CAGACTGT	GTGYCAGCMGCCGCGGTAA	GACTACHVGGGTATCTAATCC
Bacteria.10degrees.13C.Acetate.Lepidocrocite.Fraction.Light	CAGTTCAG	GTGYCAGCMGCCGCGGTAA	GACTACHVGGGTATCTAATCC
Bacteria.10degrees.13C.Acetate.Lepidocrocite.Fraction.Ultra-light	CCAACCTT	GTGYCAGCMGCCGCGGTAA	GACTACHVGGGTATCTAATCC
Bacteria.10degrees.13C.Acetate.Sulfate.Fraction.Ultra-heavy	CCTACGAA	GTGYCAGCMGCCGCGGTAA	GACTACHVGGGTATCTAATCC
Bacteria.10degrees.13C.Acetate.Sulfate.Fraction.Heavy	CGAAGGAT	GTGYCAGCMGCCGCGGTAA	GACTACHVGGGTATCTAATCC
Bacteria.10degrees.13C.Acetate.Sulfate.Fraction.Midpoint	CTCAACAG	GTGYCAGCMGCCGCGGTAA	GACTACHVGGGTATCTAATCC
Bacteria.10degrees.13C.Acetate.Sulfate.Fraction.Light	GACATGAG	GTGYCAGCMGCCGCGGTAA	GACTACHVGGGTATCTAATCC
Bacteria.10degrees.13C.Acetate.Sulfate.Fraction.Ultra-light	GCATGGAA	GTGYCAGCMGCCGCGGTAA	GACTACHVGGGTATCTAATCC
Bacteria.10degrees.13C.Acetate.Fraction.Ultra-heavy	GTTGGTTG	GTGYCAGCMGCCGCGGTAA	GACTACHVGGGTATCTAATCC
Bacteria.10degrees.13C.Acetate.Fraction.Heavy	TCAGAGAG	GTGYCAGCMGCCGCGGTAA	GACTACHVGGGTATCTAATCC
Bacteria.10degrees.13C.Acetate.Fraction.Midpoint	TGTGGTGT	GTGYCAGCMGCCGCGGTAA	GACTACHVGGGTATCTAATCC
Bacteria.10degrees.13C.Acetate.Fraction.Light	TTCGTAGG	GTGYCAGCMGCCGCGGTAA	GACTACHVGGGTATCTAATCC
Bacteria.10degrees.13C.Acetate.Fraction.Ultra-light	ACACCTCT	GTGYCAGCMGCCGCGGTAA	GACTACHVGGGTATCTAATCC
Bacteria.10degrees.12C.Acetate.Fraction.Ultra-heavy	ACTGTGTG	GTGYCAGCMGCCGCGGTAA	GACTACHVGGGTATCTAATCC
Bacteria.10degrees.12C.Acetate.Fraction.Heavy	CAACTCCT	GTGYCAGCMGCCGCGGTAA	GACTACHVGGGTATCTAATCC
Bacteria.10degrees.12C.Acetate.Fraction.Midpoint	CGAATAGG	GTGYCAGCMGCCGCGGTAA	GACTACHVGGGTATCTAATCC
Bacteria.10degrees.12C.Acetate.Fraction.Light	CGTTGCAA	GTGYCAGCMGCCGCGGTAA	GACTACHVGGGTATCTAATCC
Bacteria.10degrees.12C.Acetate.Fraction.Ultra-light	CTTCCATG	GTGYCAGCMGCCGCGGTAA	GACTACHVGGGTATCTAATCC
