#SampleID	BarcodeSequence	ForwardPrimer	ReversePrimer
Bacteria.15degrees.12C.Acetate.Fraction.Heavy	TCACTCTG	GTGYCAGCMGCCGCGGTAA	GACTACHVGGGTATCTAATCC
Bacteria.15degrees.12C.Acetate.Fraction.Light	TGACTCAG	GTGYCAGCMGCCGCGGTAA	GACTACHVGGGTATCTAATCC
Bacteria.15degrees.12C.Acetate.Fraction.Midpoint	TCTCCAGT	GTGYCAGCMGCCGCGGTAA	GACTACHVGGGTATCTAATCC
Bacteria.15degrees.12C.Acetate.Fraction.Ultra-heavy	TACGATCG	GTGYCAGCMGCCGCGGTAA	GACTACHVGGGTATCTAATCC
Bacteria.15degrees.12C.Acetate.Fraction.Ultra-light	TGGTTCCT	GTGYCAGCMGCCGCGGTAA	GACTACHVGGGTATCTAATCC
Bacteria.15degrees.12C.Acetate.Lepidocrocite.Fraction.Heavy	GAGAGACT	GTGYCAGCMGCCGCGGTAA	GACTACHVGGGTATCTAATCC
Bacteria.15degrees.12C.Acetate.Lepidocrocite.Fraction.Light	GCAATAGG	GTGYCAGCMGCCGCGGTAA	GACTACHVGGGTATCTAATCC
Bacteria.15degrees.12C.Acetate.Lepidocrocite.Fraction.Midpoint	GATCGAAG	GTGYCAGCMGCCGCGGTAA	GACTACHVGGGTATCTAATCC
Bacteria.15degrees.12C.Acetate.Lepidocrocite.Fraction.Ultra-heavy	GACATCTG	GTGYCAGCMGCCGCGGTAA	GACTACHVGGGTATCTAATCC
Bacteria.15degrees.12C.Acetate.Lepidocrocite.Fraction.Ultra-light	GCTACCTT	GTGYCAGCMGCCGCGGTAA	GACTACHVGGGTATCTAATCC
Bacteria.15degrees.12C.Acetate.Sulfate.Fraction.Heavy	GGTTCCTT	GTGYCAGCMGCCGCGGTAA	GACTACHVGGGTATCTAATCC
Bacteria.15degrees.12C.Acetate.Sulfate.Fraction.Light	GTGAGTCT	GTGYCAGCMGCCGCGGTAA	GACTACHVGGGTATCTAATCC
Bacteria.15degrees.12C.Acetate.Sulfate.Fraction.Midpoint	GTCATCAG	GTGYCAGCMGCCGCGGTAA	GACTACHVGGGTATCTAATCC
Bacteria.15degrees.12C.Acetate.Sulfate.Fraction.Ultra-heavy	GGATATGG	GTGYCAGCMGCCGCGGTAA	GACTACHVGGGTATCTAATCC
Bacteria.15degrees.12C.Acetate.Sulfate.Fraction.Ultra-light	GTTCGATG	GTGYCAGCMGCCGCGGTAA	GACTACHVGGGTATCTAATCC
Bacteria.15degrees.13C.Acetate.Fraction.Heavy	CTAGTGGT	GTGYCAGCMGCCGCGGTAA	GACTACHVGGGTATCTAATCC
Bacteria.15degrees.13C.Acetate.Fraction.Light	CTGTGAGT	GTGYCAGCMGCCGCGGTAA	GACTACHVGGGTATCTAATCC
Bacteria.15degrees.13C.Acetate.Fraction.Midpoint	CTCTGACT	GTGYCAGCMGCCGCGGTAA	GACTACHVGGGTATCTAATCC
Bacteria.15degrees.13C.Acetate.Fraction.Ultra-heavy	CGTAGGAA	GTGYCAGCMGCCGCGGTAA	GACTACHVGGGTATCTAATCC
Bacteria.15degrees.13C.Acetate.Fraction.Ultra-light	GAACCTTG	GTGYCAGCMGCCGCGGTAA	GACTACHVGGGTATCTAATCC
Bacteria.15degrees.13C.Acetate.Lepidocrocite.Fraction.Heavy	AAGGTACG	GTGYCAGCMGCCGCGGTAA	GACTACHVGGGTATCTAATCC
Bacteria.15degrees.13C.Acetate.Lepidocrocite.Fraction.Light	ACGTGTTG	GTGYCAGCMGCCGCGGTAA	GACTACHVGGGTATCTAATCC
Bacteria.15degrees.13C.Acetate.Lepidocrocite.Fraction.Midpoint	ACCTACCT	GTGYCAGCMGCCGCGGTAA	GACTACHVGGGTATCTAATCC
Bacteria.15degrees.13C.Acetate.Lepidocrocite.Fraction.Ultra-heavy	AACCAAGG	GTGYCAGCMGCCGCGGTAA	GACTACHVGGGTATCTAATCC
Bacteria.15degrees.13C.Acetate.Lepidocrocite.Fraction.Ultra-light	ACTGGACT	GTGYCAGCMGCCGCGGTAA	GACTACHVGGGTATCTAATCC
Bacteria.15degrees.13C.Acetate.Sulfate.Fraction.Heavy	CAGTGACT	GTGYCAGCMGCCGCGGTAA	GACTACHVGGGTATCTAATCC
Bacteria.15degrees.13C.Acetate.Sulfate.Fraction.Light	CCTACCAT	GTGYCAGCMGCCGCGGTAA	GACTACHVGGGTATCTAATCC
Bacteria.15degrees.13C.Acetate.Sulfate.Fraction.Midpoint	CATGTGGT	GTGYCAGCMGCCGCGGTAA	GACTACHVGGGTATCTAATCC
Bacteria.15degrees.13C.Acetate.Sulfate.Fraction.Ultra-heavy	CAGAAGTG	GTGYCAGCMGCCGCGGTAA	GACTACHVGGGTATCTAATCC
Bacteria.15degrees.13C.Acetate.Sulfate.Fraction.Ultra-light	CGAACGTT	GTGYCAGCMGCCGCGGTAA	GACTACHVGGGTATCTAATCC
Bacteria.20degrees.12C.Acetate.Fraction.Heavy	GCTACGAT	GTGYCAGCMGCCGCGGTAA	GACTACHVGGGTATCTAATCC
Bacteria.20degrees.12C.Acetate.Fraction.Light	GGTTCGAT	GTGYCAGCMGCCGCGGTAA	GACTACHVGGGTATCTAATCC
Bacteria.20degrees.12C.Acetate.Fraction.Midpoint	GGATCCAT	GTGYCAGCMGCCGCGGTAA	GACTACHVGGGTATCTAATCC
Bacteria.20degrees.12C.Acetate.Fraction.Ultra-heavy	GCATGGAA	GTGYCAGCMGCCGCGGTAA	GACTACHVGGGTATCTAATCC
Bacteria.20degrees.12C.Acetate.Fraction.Ultra-light	GTCTACAG	GTGYCAGCMGCCGCGGTAA	GACTACHVGGGTATCTAATCC
Bacteria.20degrees.12C.Acetate.Lepidocrocite.Fraction.Heavy	CGAAGGAT	GTGYCAGCMGCCGCGGTAA	GACTACHVGGGTATCTAATCC
Bacteria.20degrees.12C.Acetate.Lepidocrocite.Fraction.Light	CTCAACAG	GTGYCAGCMGCCGCGGTAA	GACTACHVGGGTATCTAATCC
Bacteria.20degrees.12C.Acetate.Lepidocrocite.Fraction.Midpoint	CGTTCGTT	GTGYCAGCMGCCGCGGTAA	GACTACHVGGGTATCTAATCC
Bacteria.20degrees.12C.Acetate.Lepidocrocite.Fraction.Ultra-heavy	CCTACGAA	GTGYCAGCMGCCGCGGTAA	GACTACHVGGGTATCTAATCC
Bacteria.20degrees.12C.Acetate.Lepidocrocite.Fraction.Ultra-light	CTGAACTG	GTGYCAGCMGCCGCGGTAA	GACTACHVGGGTATCTAATCC
Bacteria.20degrees.12C.Acetate.Sulfate.Fraction.Heavy	GAACGATG	GTGYCAGCMGCCGCGGTAA	GACTACHVGGGTATCTAATCC
Bacteria.20degrees.12C.Acetate.Sulfate.Fraction.Light	GAGAGTGT	GTGYCAGCMGCCGCGGTAA	GACTACHVGGGTATCTAATCC
Bacteria.20degrees.12C.Acetate.Sulfate.Fraction.Midpoint	GACATGAG	GTGYCAGCMGCCGCGGTAA	GACTACHVGGGTATCTAATCC
Bacteria.20degrees.12C.Acetate.Sulfate.Fraction.Ultra-heavy	CTGTTCTG	GTGYCAGCMGCCGCGGTAA	GACTACHVGGGTATCTAATCC
Bacteria.20degrees.12C.Acetate.Sulfate.Fraction.Ultra-light	GATCGTTG	GTGYCAGCMGCCGCGGTAA	GACTACHVGGGTATCTAATCC
Bacteria.20degrees.13C.Acetate.Fraction.Heavy	CACATCAG	GTGYCAGCMGCCGCGGTAA	GACTACHVGGGTATCTAATCC
Bacteria.20degrees.13C.Acetate.Fraction.Light	CAGTTCAG	GTGYCAGCMGCCGCGGTAA	GACTACHVGGGTATCTAATCC
Bacteria.20degrees.13C.Acetate.Fraction.Midpoint	CAGACTGT	GTGYCAGCMGCCGCGGTAA	GACTACHVGGGTATCTAATCC
Bacteria.20degrees.13C.Acetate.Fraction.Ultra-heavy	CAACCTAG	GTGYCAGCMGCCGCGGTAA	GACTACHVGGGTATCTAATCC
Bacteria.20degrees.13C.Acetate.Fraction.Ultra-light	CCAACCTT	GTGYCAGCMGCCGCGGTAA	GACTACHVGGGTATCTAATCC
Bacteria.20degrees.13C.Acetate.Lepidocrocite.Fraction.Heavy	TTCGATGG	GTGYCAGCMGCCGCGGTAA	GACTACHVGGGTATCTAATCC
Bacteria.20degrees.13C.Acetate.Lepidocrocite.Fraction.Light	ACACACTG	GTGYCAGCMGCCGCGGTAA	GACTACHVGGGTATCTAATCC
Bacteria.20degrees.13C.Acetate.Lepidocrocite.Fraction.Midpoint	AACCGGTT	GTGYCAGCMGCCGCGGTAA	GACTACHVGGGTATCTAATCC
Bacteria.20degrees.13C.Acetate.Lepidocrocite.Fraction.Ultra-heavy	TGTGACTG	GTGYCAGCMGCCGCGGTAA	GACTACHVGGGTATCTAATCC
Bacteria.20degrees.13C.Acetate.Lepidocrocite.Fraction.Ultra-light	ACCTAGGT	GTGYCAGCMGCCGCGGTAA	GACTACHVGGGTATCTAATCC
Bacteria.20degrees.13C.Acetate.Sulfate.Fraction.Heavy	ACTGTCAG	GTGYCAGCMGCCGCGGTAA	GACTACHVGGGTATCTAATCC
Bacteria.20degrees.13C.Acetate.Sulfate.Fraction.Light	AGTCTCAG	GTGYCAGCMGCCGCGGTAA	GACTACHVGGGTATCTAATCC
Bacteria.20degrees.13C.Acetate.Sulfate.Fraction.Midpoint	AGGAGAAG	GTGYCAGCMGCCGCGGTAA	GACTACHVGGGTATCTAATCC
Bacteria.20degrees.13C.Acetate.Sulfate.Fraction.Ultra-heavy	ACGTTGGT	GTGYCAGCMGCCGCGGTAA	GACTACHVGGGTATCTAATCC
Bacteria.20degrees.13C.Acetate.Sulfate.Fraction.Ultra-light	ATCCAACG	GTGYCAGCMGCCGCGGTAA	GACTACHVGGGTATCTAATCC
Bacteria.25degrees.12C.Acetate.Fraction.Heavy	CTGACAGT	GTGYCAGCMGCCGCGGTAA	GACTACHVGGGTATCTAATCC
Bacteria.25degrees.12C.Acetate.Fraction.Light	GAAGGTTG	GTGYCAGCMGCCGCGGTAA	GACTACHVGGGTATCTAATCC
Bacteria.25degrees.12C.Acetate.Fraction.Midpoint	CTTCCATG	GTGYCAGCMGCCGCGGTAA	GACTACHVGGGTATCTAATCC
Bacteria.25degrees.12C.Acetate.Fraction.Ultra-heavy	CTCAAGTG	GTGYCAGCMGCCGCGGTAA	GACTACHVGGGTATCTAATCC
Bacteria.25degrees.12C.Acetate.Fraction.Ultra-light	GACTACTG	GTGYCAGCMGCCGCGGTAA	GACTACHVGGGTATCTAATCC
Bacteria.25degrees.12C.Acetate.Lepidocrocite.Fraction.Heavy	ATCCGGAT	GTGYCAGCMGCCGCGGTAA	GACTACHVGGGTATCTAATCC
Bacteria.25degrees.12C.Acetate.Lepidocrocite.Fraction.Light	CACATGTG	GTGYCAGCMGCCGCGGTAA	GACTACHVGGGTATCTAATCC
Bacteria.25degrees.12C.Acetate.Lepidocrocite.Fraction.Midpoint	CAACTCCT	GTGYCAGCMGCCGCGGTAA	GACTACHVGGGTATCTAATCC
Bacteria.25degrees.12C.Acetate.Lepidocrocite.Fraction.Ultra-heavy	AGTGACAG	GTGYCAGCMGCCGCGGTAA	GACTACHVGGGTATCTAATCC
Bacteria.25degrees.12C.Acetate.Lepidocrocite.Fraction.Ultra-light	CAGAGTCT	GTGYCAGCMGCCGCGGTAA	GACTACHVGGGTATCTAATCC
Bacteria.25degrees.12C.Acetate.Sulfate.Fraction.Heavy	CCAAGGAA	GTGYCAGCMGCCGCGGTAA	GACTACHVGGGTATCTAATCC
Bacteria.25degrees.12C.Acetate.Sulfate.Fraction.Light	CGAATAGG	GTGYCAGCMGCCGCGGTAA	GACTACHVGGGTATCTAATCC
Bacteria.25degrees.12C.Acetate.Sulfate.Fraction.Midpoint	CCTACGTT	GTGYCAGCMGCCGCGGTAA	GACTACHVGGGTATCTAATCC
Bacteria.25degrees.12C.Acetate.Sulfate.Fraction.Ultra-heavy	CATCACCT	GTGYCAGCMGCCGCGGTAA	GACTACHVGGGTATCTAATCC
Bacteria.25degrees.12C.Acetate.Sulfate.Fraction.Ultra-light	CGTTGCAA	GTGYCAGCMGCCGCGGTAA	GACTACHVGGGTATCTAATCC
Bacteria.25degrees.13C.Acetate.Fraction.Heavy	ACGAACCT	GTGYCAGCMGCCGCGGTAA	GACTACHVGGGTATCTAATCC
Bacteria.25degrees.13C.Acetate.Fraction.Light	ACTGTGTG	GTGYCAGCMGCCGCGGTAA	GACTACHVGGGTATCTAATCC
Bacteria.25degrees.13C.Acetate.Fraction.Midpoint	ACTCACAG	GTGYCAGCMGCCGCGGTAA	GACTACHVGGGTATCTAATCC
Bacteria.25degrees.13C.Acetate.Fraction.Ultra-heavy	ACACCTCT	GTGYCAGCMGCCGCGGTAA	GACTACHVGGGTATCTAATCC
Bacteria.25degrees.13C.Acetate.Fraction.Ultra-light	AGGATGGT	GTGYCAGCMGCCGCGGTAA	GACTACHVGGGTATCTAATCC
Bacteria.25degrees.13C.Acetate.Lepidocrocite.Fraction.Heavy	GTTGGTTG	GTGYCAGCMGCCGCGGTAA	GACTACHVGGGTATCTAATCC
Bacteria.25degrees.13C.Acetate.Lepidocrocite.Fraction.Light	TCAGAGAG	GTGYCAGCMGCCGCGGTAA	GACTACHVGGGTATCTAATCC
Bacteria.25degrees.13C.Acetate.Lepidocrocite.Fraction.Midpoint	TACGTACG	GTGYCAGCMGCCGCGGTAA	GACTACHVGGGTATCTAATCC
Bacteria.25degrees.13C.Acetate.Lepidocrocite.Fraction.Ultra-heavy	GTGATGAG	GTGYCAGCMGCCGCGGTAA	GACTACHVGGGTATCTAATCC
Bacteria.25degrees.13C.Acetate.Lepidocrocite.Fraction.Ultra-light	TCTCGACT	GTGYCAGCMGCCGCGGTAA	GACTACHVGGGTATCTAATCC
Bacteria.25degrees.13C.Acetate.Sulfate.Fraction.Heavy	TGGTTGGT	GTGYCAGCMGCCGCGGTAA	GACTACHVGGGTATCTAATCC
Bacteria.25degrees.13C.Acetate.Sulfate.Fraction.Light	TTCGTAGG	GTGYCAGCMGCCGCGGTAA	GACTACHVGGGTATCTAATCC
Bacteria.25degrees.13C.Acetate.Sulfate.Fraction.Midpoint	TGTGGTGT	GTGYCAGCMGCCGCGGTAA	GACTACHVGGGTATCTAATCC
Bacteria.25degrees.13C.Acetate.Sulfate.Fraction.Ultra-heavy	TGAGACAG	GTGYCAGCMGCCGCGGTAA	GACTACHVGGGTATCTAATCC
Bacteria.25degrees.13C.Acetate.Sulfate.Fraction.Ultra-light	AACGATGG	GTGYCAGCMGCCGCGGTAA	GACTACHVGGGTATCTAATCC
